#######
#     #
#   $ #
# @  ##
#  *  #
#  .  #
#######
