#######
# @ ###
##$   #
#     #
# .   #
#######
