#######
#     #
# $.  #
# $   #
#   @##
#     #
#     #
#     #
# .   #
#######
