#######
#*    #
#   $ #
# . # #
#  @  #
#######
