#########
#       #
#    #  #
#      ##
# . #   #
#    $  #
#     @ #
# $.    #
#########
