########
#      #
#   $  #
#    @ #
#     .#
#     *#
#      #
#  #   #
########
