#########
##  ###.#
#     # #
##  #   #
##  #  $#
#.   $ @#
#########
