##########
#     #  #
# *#     #
#  #  *  #
# $.     #
#        #
#     # @#
##########
