#########
#  .$ * #
# *     #
#@      #
#  $  . #
#       #
#########
