##########
#  #     #
#    @   #
# .      #
#     #  #
#        #
#     $  #
#  $     #
#   .    #
##########
