########
#      #
#     ##
# $@  .#
##$#   #
#  .   #
#      #
########
