########
#      #
# $*.  #
#@     #
#  $   #
#.     #
########
