########
#   .  #
#   $. #
#*  $  #
#    @ #
# *    #
#      #
########
