#########
#       #
#   $#  #
#   @   #
#    . *#
#     * #
#  $   .#
#########
