########
#  #*  #
#   @ .#
#   #  #
# #$   #
#   *  #
#      #
########
