########
# . $  #
#  $@  #
##*#  ##
#*.    #
##    ##
########
