#########
#.    $ #
#  $   .#
#   @  $#
#  .    #
#########
