########
#      #
# #    #
# #   ##
#      #
#@$    #
#*     #
#   #  #
# .    #
########
