######
# @. #
#    #
#*#$ #
#    #
#    #
######
