########
#    @ #
#$     #
# ##.  #
#    # #
# *    #
#  $   #
#.     #
#*#    #
########
