#########
#       #
#*      #
##*     #
#       #
# $     #
#@.     #
#       #
#       #
#########
