#######
#     #
# .   #
#  $  #
#     #
#  @  #
#  #  #
#     #
#######
