########
#@. $  #
#      #
#      #
##     #
#  #*  #
#      #
#   # ##
########
