########
#   #  #
#  *  .#
#      #
#  $   #
# @    #
#   *  #
########
