##########
##    #  #
#     #@##
##   $   #
#   #    #
##     # #
#    .*  #
#      # #
##########
