##########
#  .     #
#        #
#@ #     #
#    #   #
#   #  # #
#        #
# $      #
# #  #   #
##########
