#########
#   .   #
#       #
#       #
#       #
#  $    #
#    *@ #
#########
