########
#      #
#    * #
#   $ @#
# #   *#
#   .  #
########
