##########
#     # @#
##   $   #
# * .  # #
#        #
# # #    #
#    #   #
##########
