######
#   .#
# $  #
#    #
#    #
#   ##
# #  #
#@  *#
######
