#######
# # # #
#     #
#  @  #
#.  $ #
#     #
##    #
#    ##
#######
