#########
#       #
# @     #
#   *   #
#  #$ * #
# #    .#
#       #
#    ## #
#########
