######
## @ #
#    #
# #  #
##* *#
### ##
#.$ ##
######
