#########
##  @   #
#   *#  #
#   .   #
#   $   #
##  # # #
#    #* #
#########
