#######
#@   ##
#  $ ##
#     #
#   # #
# #   #
#.    #
#######
