#########
#       #
#       #
#    #  #
#*      #
#       #
#  @*   #
#  $    #
#     . #
#########
