#########
#  #  .@#
#* #  $ #
#     $ #
#  #*  .#
#########
