#######
#   . #
## #  #
#     #
# #  ##
#  . @#
#   $ #
#   $ #
##   ##
#######
