##########
#      * #
#   $ @  #
#  .     #
##       #
#  #     #
#        #
##########
