#########
#       #
#       #
# @     #
#   $ # #
#       #
#.   #  #
#########
