########
#.     #
#   @  #
#$  *  #
#  #   #
#   #  #
#      #
#      #
########
