##########
#.@$ *   #
# ##   * #
#     #  #
#        #
##########
