#######
#  #  #
# $#  #
# .  ##
# @#  #
#######
