##########
##     # #
# #      #
#        #
#  $ @   #
#      #.#
#   #  * #
# ##     #
##########
