#######
#    .#
##    #
#     #
# $  @#
#  #  #
#######
