#########
##    # #
# *.    #
#       #
#       #
# $  *  #
#  @ #  #
#########
