########
#  $.* #
##  #  #
#*     #
# @   $#
#     .#
########
