######
## @*#
#   .#
##   #
#    #
#  $ #
#  * #
######
