#########
#  # # ##
#       #
#       #
#  *    #
#@      #
# *     #
#. $    #
#########
