#######
#     #
#@.$  #
#     #
#     #
#######
