##########
#  *   # #
##   #   #
#*    .  #
#     $ ##
#       @#
#        #
##########
