########
#      #
# $ # @#
#   * ##
#      #
#     .#
##     #
#      #
########
