#######
#.#   #
#*    #
#@##$ #
## #  #
#     #
#     #
#######
