##########
#     #  #
#       .#
#   #$  ##
#       *#
#  #     #
#   @    #
##########
