##########
#        #
#    .   #
#        #
#        #
#      $ #
#        #
# *   $*@#
#      .##
##########
