#######
#    ##
##@ # #
##   ##
#  #  #
#. $  #
##  # #
#######
