#########
##      #
#     .@#
# #     #
#   $ # #
#       #
#       #
#########
