##########
#        #
#    *   #
#    .   #
# $      #
#        #
#  #     #
##   # # #
#  @     #
##########
