#######
# *  @#
#     #
#*$   #
#     #
#   . #
#     #
#     #
#######
