########
#     ##
#    ###
#.     #
#  #$# #
#      #
# $  . #
#  #  ##
#  ##@ #
########
