#########
#       #
## .    #
#       #
#  $    #
#    @  #
#       #
#########
