#######
# @#* #
## ## #
#    ##
## ##.#
#  # $#
# $ # #
#*.   #
#######
