#########
#   # @ #
#     # #
# *$  # #
#       #
#   #   #
#*  .   #
#########
