########
#@*##.*#
#      #
#    $ #
#  # # #
#  #####
########
