########
#      #
# @$   #
#   *  #
# $    #
#.    *#
#      #
#      #
#  .   #
########
