######
#    #
#   .#
# #$ #
#  @ #
#   ##
## * #
#    #
######
