##########
#      ###
# $ *  . #
#@  ##   #
#.    $  #
##########
