#######
#   @ #
#    ##
# * $ #
#.$   #
# # *.#
#######
