#########
##      #
# #  $ @#
# *     #
#  #    #
# * # . #
#########
