#######
#     #
#  $ *#
#@*   #
#     #
# #   #
###.  #
#     #
#    ##
#######
