#########
# *     #
#  .  ###
#    #  #
#      @#
# $#    #
#*      #
#########
