#########
#    #  #
#  #    #
#    $  #
# #  ## #
##      #
#   #   #
##  @   #
#    .  #
#########
