######
## # #
#.##*#
#$  ##
#   ##
#  @ #
# #  #
#    #
##   #
######
