#######
# #   #
### # #
#@ $  #
#   . #
# ##  #
#######
