######
#    #
#   .#
#   @#
#   $#
#  # #
#    #
#. $ #
######
