#######
#     #
#     #
#     #
#@.   #
#  $# #
#     #
#######
