#######
#  # ##
##@   #
# #   #
## #  #
# ##  #
##  $.#
# #  *#
#     #
#######
