########
# #  * #
#      #
## $.$ #
# @. # #
########
