#########
#      ##
# $    ##
##  #   #
# @.# # #
#########
