########
##  @*##
##     #
#  #.  #
#      #
#      #
#$$    #
#.     #
# #   ##
########
