##########
#      # #
#     .# #
##     ###
#       @#
# #      #
#    $   #
##  #    #
##########
