########
#   ## #
# #@   #
# * ##*#
#  ##  #
#  .   #
#  $   #
# # #  #
########
