########
#  @## #
### #  #
##   $.#
#  #   #
#      #
# * ## #
#    # #
########
