######
#   *#
# @$ #
# . ##
#    #
#    #
##   #
######
