########
# #    #
#  @#  #
#      #
# .$   #
#*#*   #
#      #
#      #
########
