##########
#       .#
#     $  #
#     . $#
#     .  #
#        #
#  #  $@ #
# #      #
##########
