########
#     *#
#      #
#   #@ #
#      #
# *    #
#      #
#      #
#  $ . #
########
