#######
#*# . #
#  #$ #
#     #
#     #
#@  $ #
#   *.#
#######
