#######
# #   #
#.$ ###
##@   #
#     #
#######
