#########
# #     #
#     * #
#  .  ###
#@ .# # #
#  $$   #
#    # ##
#########
