#########
#       #
#       #
### #   #
##@ $.  #
#########
