#######
#@. $ #
#     #
#     #
#     #
#     #
#     #
#######
