#######
##@  ##
#   * #
# $   #
#  #  #
#  * .#
##### #
#######
