#######
#  * @#
#  .# #
#  #  #
## $  #
##   *#
#######
