##########
#  #     #
#  #   @$#
# #      #
## $  #  #
# .     .#
##########
