#######
#     #
#     #
# @   #
#     #
# #$  #
#     #
# .   #
#######
