##########
#     *  #
#    *#  #
#      @ #
#  $   . #
##########
