#########
# .  #  #
##      #
#     # #
###@$# ##
#       #
#########
