#########
#   .   #
#* $   @#
#   # ###
###   ###
#########
