######
#    #
# $ .#
#.@$ #
#*  *#
######
